
10,10,49,49,49,52,35,35,35,35,36,09,07,00,00,00,00,00,00,00,00,00,00,00,00,00,00,00,00,00,00,00,00,00,00,00,00,00,03,09,09,37,35,35,35,35,35,57,49,49,49,49,49,49,49,49,49,49,49,49;
10,10,49,49,49,52,35,35,35,35,36,09,07,00,00,00,00,00,00,00,00,00,00,00,00,00,00,00,00,00,00,00,00,00,00,00,00,00,03,09,09,37,35,35,35,35,35,57,49,49,49,49,49,49,49,49,49,49,49,49;
10,10,49,49,49,52,35,35,35,35,36,09,07,00,00,00,00,00,00,00,00,00,00,00,00,00,00,00,00,00,00,00,00,00,00,00,00,05,09,09,09,37,35,35,35,35,35,57,49,49,49,49,49,49,49,49,49,49,49,49;
10,10,49,49,59,53,35,35,35,35,36,09,06,05,05,05,00,00,00,00,00,00,00,00,00,00,00,00,00,00,00,00,00,00,00,00,05,09,09,09,42,46,35,35,35,35,56,60,49,49,49,49,49,49,49,49,49,49,49,49;
10,10,49,49,52,35,35,35,35,35,36,09,09,09,09,09,07,00,00,00,00,00,00,00,00,00,00,00,00,00,00,00,00,00,00,05,09,09,09,09,37,35,35,35,35,35,57,49,49,49,49,49,49,49,49,49,49,49,49,49;
10,10,49,49,52,35,35,35,35,35,36,09,09,09,09,09,06,05,05,05,05,05,05,00,00,00,00,00,00,00,00,00,00,00,00,09,09,09,09,42,46,35,35,35,35,56,60,49,49,49,49,49,49,49,49,49,49,49,49,10;
10,10,49,49,52,35,35,35,35,35,47,43,09,09,09,09,11,09,09,09,11,09,09,00,00,00,00,00,00,00,00,00,00,00,05,09,09,09,09,37,35,35,35,35,35,57,49,49,49,49,49,59,54,54,48,49,49,49,10,10;
10,10,49,49,52,35,35,35,35,35,35,36,09,09,09,18,10,12,09,18,10,12,09,05,00,00,00,00,00,00,00,00,00,00,09,09,09,09,42,46,35,35,35,35,35,57,49,49,59,54,54,53,35,35,55,48,49,49,10,10;
10,10,49,49,58,51,35,35,35,35,35,36,09,09,18,22,10,19,11,22,10,19,12,09,07,00,00,00,00,00,00,00,00,00,09,09,09,09,37,35,35,35,35,35,35,57,49,59,53,35,35,35,35,35,35,55,48,49,10,10;
10,10,49,49,49,52,35,35,35,35,35,47,43,09,16,21,10,10,10,10,10,20,14,09,07,00,00,00,00,00,00,00,00,05,09,09,09,42,46,35,35,35,35,35,56,60,49,52,35,35,35,35,35,35,35,35,57,49,10,10;
10,10,49,49,49,52,35,35,35,35,35,35,36,09,09,16,21,10,10,10,20,14,09,09,07,00,00,00,00,00,00,05,05,09,09,09,09,37,35,35,35,35,35,35,57,49,59,53,35,35,35,35,35,35,35,35,57,49,10,10;
10,10,10,49,49,52,35,35,35,35,35,35,36,09,09,09,16,21,10,10,13,09,09,07,00,00,00,00,00,00,03,09,09,09,09,42,38,46,35,35,35,35,35,56,60,49,52,35,35,35,35,35,35,35,35,35,57,49,10,10;
10,10,10,49,49,52,35,35,35,35,35,35,47,43,09,09,09,16,21,20,14,09,09,07,00,00,00,00,00,00,03,09,09,09,09,37,35,35,35,35,35,35,35,57,49,59,53,35,35,35,35,35,35,35,35,35,57,49,10,10;
10,10,10,49,49,52,35,35,35,35,35,35,35,36,09,09,09,09,16,14,09,09,09,07,00,00,00,00,00,00,03,09,09,09,09,37,35,35,35,35,35,35,56,60,49,52,35,35,35,35,35,35,35,35,35,35,57,49,10,10;
10,10,10,49,49,52,35,35,35,35,35,35,35,47,43,09,09,09,09,09,09,07,00,00,00,00,00,00,00,00,03,09,09,09,42,46,35,35,35,35,35,56,60,49,49,52,35,35,35,35,35,35,35,35,35,35,57,49,10,10;
10,10,10,10,49,58,51,35,35,35,35,35,35,35,36,09,09,09,09,09,07,00,00,00,00,00,00,00,00,00,03,09,09,42,46,35,35,35,35,35,35,57,49,49,49,52,35,35,35,35,35,35,35,35,35,56,60,49,10,10;
10,10,10,10,49,49,58,51,35,35,35,35,35,35,47,43,09,09,09,09,07,00,00,00,00,00,00,00,00,00,03,09,42,46,35,35,35,35,35,35,56,60,49,49,49,52,35,35,35,35,35,35,35,35,35,57,49,49,10,10;
10,10,10,10,10,49,49,58,51,35,35,35,35,35,35,47,43,09,09,09,07,00,00,00,00,00,00,00,00,00,03,42,46,35,35,35,35,35,35,35,57,49,49,49,49,52,35,35,35,35,35,35,35,35,35,57,49,49,10,10;
10,10,10,10,10,49,49,49,52,35,35,35,35,35,35,35,47,43,09,09,09,09,07,00,00,00,00,00,00,00,03,37,35,35,35,35,35,35,35,35,57,49,49,49,49,52,35,35,35,35,35,35,35,35,35,57,49,10,10,10;
10,10,10,10,10,10,49,49,58,51,35,35,35,35,35,35,35,47,43,09,09,09,07,00,00,00,00,00,03,09,09,37,35,35,35,35,35,35,35,56,60,49,49,49,49,52,35,35,35,35,35,35,35,35,56,60,49,10,10,10;
10,10,10,10,10,10,49,49,49,52,35,35,35,35,35,35,35,35,47,43,09,09,09,09,07,00,00,00,03,09,42,46,35,35,35,35,35,35,56,60,49,49,49,49,49,52,35,35,35,35,35,35,35,56,60,49,49,10,10,10;
10,10,10,10,10,10,10,49,49,58,50,51,35,35,35,35,35,35,35,47,43,09,09,09,09,09,09,09,09,09,37,35,35,35,35,35,35,56,60,49,49,49,49,49,49,58,51,35,35,35,35,35,56,60,49,49,10,10,10,10;
10,10,10,10,10,10,10,10,49,49,49,52,35,35,35,35,35,35,35,35,47,43,09,09,09,09,09,09,09,42,46,35,35,35,35,35,56,60,49,49,49,49,49,49,49,49,58,50,50,50,50,50,60,49,49,10,10,10,10,10;
10,10,10,10,10,10,10,10,49,49,49,58,51,35,35,35,35,35,35,35,35,47,38,43,09,09,09,09,42,46,35,35,35,35,35,35,57,49,49,49,49,49,49,49,49,49,49,49,49,49,49,49,49,49,10,10,10,10,10,10;
10,10,10,10,10,10,10,10,49,49,49,49,58,51,35,35,35,35,35,35,35,35,35,47,43,42,38,38,46,35,35,35,35,35,35,56,60,49,49,49,49,10,10,10,10,10,10,10,10,10,10,10,10,10,10,10,10,10,10,10;
10,10,10,10,10,10,10,10,10,49,49,49,49,58,51,35,35,35,35,35,35,35,35,35,47,46,35,35,35,35,35,35,35,35,35,57,49,49,49,49,49,10,10,10,10,10,10,10,10,10,10,10,10,10,10,10,10,10,10,10;
10,10,10,10,10,10,10,10,10,10,49,49,49,49,58,51,35,35,35,35,35,35,35,35,35,35,35,35,35,35,35,35,35,35,56,60,49,49,49,49,10,10,10,10,10,10,10,10,10,10,10,10,10,10,10,10,10,10,10,10;
10,10,10,10,10,10,10,10,10,10,10,10,49,49,49,58,50,50,51,35,35,35,35,35,35,35,35,35,35,35,35,35,35,56,60,49,49,49,49,49,10,10,10,10,10,10,10,10,10,10,10,10,10,10,10,10,10,10,10,10;
10,10,10,10,10,10,10,10,10,10,10,10,10,49,49,49,49,49,58,51,35,35,35,35,35,35,35,35,35,35,35,35,35,57,49,49,49,49,49,10,10,10,10,10,10,10,10,10,10,10,10,10,10,10,10,10,10,10,10,10;
10,10,10,10,10,10,10,10,10,10,10,10,10,49,49,49,49,49,49,58,51,35,35,35,35,35,35,35,35,35,35,56,50,60,49,49,49,49,10,10,10,10,10,10,10,10,10,10,10,10,10,10,10,10,10,10,10,10,10,10;
10,10,10,10,10,10,10,10,10,10,10,10,10,10,49,49,49,49,49,49,58,50,50,50,50,50,50,50,50,50,50,60,49,49,49,49,49,10,10,10,10,10,10,10,10,10,10,10,10,10,10,10,10,10,10,10,10,10,10,10;
10,10,10,10,10,10,10,10,10,10,10,10,10,10,10,49,49,49,49,49,49,49,49,49,49,49,49,49,49,49,49,49,49,49,49,10,10,10,10,10,10,10,10,10,10,10,10,10,10,10,10,10,10,10,10,10,10,10,10,10;
10,10,10,10,10,10,10,10,10,10,10,10,10,10,10,10,10,10,10,10,49,49,49,49,49,49,49,49,49,49,49,49,49,10,10,10,10,10,10,10,10,10,10,10,10,10,10,10,10,10,10,10,10,10,10,10,10,10,10,10;
10,10,10,10,10,10,10,10,10,10,10,10,10,10,10,10,10,10,10,10,10,10,10,10,10,10,10,10,10,10,10,10,10,10,10,10,10,10,10,10,10,10,10,10,10,10,10,10,10,10,10,10,10,10,10,10,10,10,10,10;

0,1,0,0,0,0,0,0,0,0,0,0,0,0,0,0,0,0,0,0,0,0,0,0,0,0,0,0,0,0,0,0,0,0,0,0,0,0,0,0,0,0,0,0,0,0,0,0,0,0,0,0,0,0,0,0,0,0,0,0
0,1,0,0,0,0,0,0,0,0,0,0,0,0,0,0,0,0,0,0,0,0,0,0,0,0,0,0,0,0,0,0,0,0,0,0,0,0,0,0,0,0,0,0,0,0,0,0,0,0,0,0,0,0,0,0,0,0,0,0
0,1,0,0,0,0,0,0,0,0,0,0,0,0,0,0,0,0,0,0,0,0,0,0,0,0,0,0,0,0,0,0,0,0,0,0,0,0,0,0,0,0,0,0,0,0,0,0,0,0,0,0,0,0,0,0,0,0,0,0
0,1,0,0,0,0,0,0,0,0,0,0,0,0,0,0,0,0,0,0,0,0,0,0,0,0,0,0,0,0,0,0,0,0,0,0,0,0,0,0,0,0,0,0,0,0,0,0,0,0,0,0,0,0,0,0,0,0,0,0
0,1,0,0,0,0,0,0,0,0,0,0,0,0,0,0,0,0,0,0,0,0,0,0,0,0,0,0,0,0,0,0,0,0,0,0,0,0,0,0,0,0,0,0,0,0,0,0,0,0,0,0,0,0,0,0,0,0,0,0
0,1,0,0,0,0,0,0,0,0,0,0,0,0,0,0,0,0,0,0,0,0,0,0,0,0,0,0,0,0,0,0,0,0,0,0,0,0,0,0,0,0,0,0,0,0,0,0,0,0,0,0,0,0,0,0,0,0,0,1
0,1,0,0,0,0,0,0,0,0,0,0,0,0,0,0,1,0,0,0,1,0,0,0,0,0,0,0,0,0,0,0,0,0,0,0,0,0,0,0,0,0,0,0,0,0,0,0,0,0,0,0,0,0,0,0,0,0,1,0
0,1,0,0,0,0,0,0,0,0,0,0,0,0,0,1,0,1,0,1,0,1,0,0,0,0,0,0,0,0,0,0,0,0,0,0,0,0,0,0,0,0,0,0,0,0,0,0,0,0,0,0,0,0,0,0,0,0,1,0
0,1,0,0,0,0,0,0,0,0,0,0,0,0,1,0,0,0,1,0,0,0,1,0,0,0,0,0,0,0,0,0,0,0,0,0,0,0,0,0,0,0,0,0,0,0,0,0,0,0,0,0,0,0,0,0,0,0,1,0
0,1,0,0,0,0,0,0,0,0,0,0,0,0,1,0,0,0,0,0,0,0,1,0,0,0,0,0,0,0,0,0,0,0,0,0,0,0,0,0,0,0,0,0,0,0,0,0,0,0,0,0,0,0,0,0,0,0,1,0
0,1,0,0,0,0,0,0,0,0,0,0,0,0,0,1,0,0,0,0,0,1,0,0,0,0,0,0,0,0,0,0,0,0,0,0,0,0,0,0,0,0,0,0,0,0,0,0,0,0,0,0,0,0,0,0,0,0,1,0
0,0,1,0,0,0,0,0,0,0,0,0,0,0,0,0,1,0,0,0,1,0,0,0,0,0,0,0,0,0,0,0,0,0,0,0,0,0,0,0,0,0,0,0,0,0,0,0,0,0,0,0,0,0,0,0,0,0,1,0
0,0,1,0,0,0,0,0,0,0,0,0,0,0,0,0,0,1,0,0,1,0,0,0,0,0,0,0,0,0,0,0,0,0,0,0,0,0,0,0,0,0,0,0,0,0,0,0,0,0,0,0,0,0,0,0,0,0,1,0
0,0,1,0,0,0,0,0,0,0,0,0,0,0,0,0,0,0,1,1,0,0,0,0,0,0,0,0,0,0,0,0,0,0,0,0,0,0,0,0,0,0,0,0,0,0,0,0,0,0,0,0,0,0,0,0,0,0,1,0
0,0,1,0,0,0,0,0,0,0,0,0,0,0,0,0,0,0,0,0,0,0,0,0,0,0,0,0,0,0,0,0,0,0,0,0,0,0,0,0,0,0,0,0,0,0,0,0,0,0,0,0,0,0,0,0,0,0,1,0
0,0,0,1,0,0,0,0,0,0,0,0,0,0,0,0,0,0,0,0,0,0,0,0,0,0,0,0,0,0,0,0,0,0,0,0,0,0,0,0,0,0,0,0,0,0,0,0,0,0,0,0,0,0,0,0,0,0,1,0
0,0,0,1,0,0,0,0,0,0,0,0,0,0,0,0,0,0,0,0,0,0,0,0,0,0,0,0,0,0,0,0,0,0,0,0,0,0,0,0,0,0,0,0,0,0,0,0,0,0,0,0,0,0,0,0,0,0,1,0
0,0,0,0,1,0,0,0,0,0,0,0,0,0,0,0,0,0,0,0,0,0,0,0,0,0,0,0,0,0,0,0,0,0,0,0,0,0,0,0,0,0,0,0,0,0,0,0,0,0,0,0,0,0,0,0,0,0,1,0
0,0,0,0,1,0,0,0,0,0,0,0,0,0,0,0,0,0,0,0,0,0,0,0,0,0,0,0,0,0,0,0,0,0,0,0,0,0,0,0,0,0,0,0,0,0,0,0,0,0,0,0,0,0,0,0,0,1,0,0
0,0,0,0,0,1,0,0,0,0,0,0,0,0,0,0,0,0,0,0,0,0,0,0,0,0,0,0,0,0,0,0,0,0,0,0,0,0,0,0,0,0,0,0,0,0,0,0,0,0,0,0,0,0,0,0,0,1,0,0
0,0,0,0,0,1,0,0,0,0,0,0,0,0,0,0,0,0,0,0,0,0,0,0,0,0,0,0,0,0,0,0,0,0,0,0,0,0,0,0,0,0,0,0,0,0,0,0,0,0,0,0,0,0,0,0,0,1,0,0
0,0,0,0,0,0,1,0,0,0,0,0,0,0,0,0,0,0,0,0,0,0,0,0,0,0,0,0,0,0,0,0,0,0,0,0,0,0,0,0,0,0,0,0,0,0,0,0,0,0,0,0,0,0,0,0,1,0,0,0
0,0,0,0,0,0,0,1,0,0,0,0,0,0,0,0,0,0,0,0,0,0,0,0,0,0,0,0,0,0,0,0,0,0,0,0,0,0,0,0,0,0,0,0,0,0,0,0,0,0,0,0,0,0,0,1,0,0,0,0
0,0,0,0,0,0,0,1,0,0,0,0,0,0,0,0,0,0,0,0,0,0,0,0,0,0,0,0,0,0,0,0,0,0,0,0,0,0,0,0,0,0,0,0,0,0,0,0,0,0,0,0,0,0,1,0,0,0,0,0
0,0,0,0,0,0,0,1,0,0,0,0,0,0,0,0,0,0,0,0,0,0,0,0,0,0,0,0,0,0,0,0,0,0,0,0,0,0,0,0,0,1,1,1,1,1,1,1,1,1,1,1,1,1,0,0,0,0,0,0
0,0,0,0,0,0,0,0,1,0,0,0,0,0,0,0,0,0,0,0,0,0,0,0,0,0,0,0,0,0,0,0,0,0,0,0,0,0,0,0,0,1,0,0,0,0,0,0,0,0,0,0,0,0,0,0,0,0,0,0
0,0,0,0,0,0,0,0,0,1,0,0,0,0,0,0,0,0,0,0,0,0,0,0,0,0,0,0,0,0,0,0,0,0,0,0,0,0,0,0,1,0,0,0,0,0,0,0,0,0,0,0,0,0,0,0,0,0,0,0
0,0,0,0,0,0,0,0,0,0,1,1,0,0,0,0,0,0,0,0,0,0,0,0,0,0,0,0,0,0,0,0,0,0,0,0,0,0,0,0,1,0,0,0,0,0,0,0,0,0,0,0,0,0,0,0,0,0,0,0
0,0,0,0,0,0,0,0,0,0,0,0,1,0,0,0,0,0,0,0,0,0,0,0,0,0,0,0,0,0,0,0,0,0,0,0,0,0,0,1,0,0,0,0,0,0,0,0,0,0,0,0,0,0,0,0,0,0,0,0
0,0,0,0,0,0,0,0,0,0,0,0,1,0,0,0,0,0,0,0,0,0,0,0,0,0,0,0,0,0,0,0,0,0,0,0,0,0,1,0,0,0,0,0,0,0,0,0,0,0,0,0,0,0,0,0,0,0,0,0
0,0,0,0,0,0,0,0,0,0,0,0,0,1,0,0,0,0,0,0,0,0,0,0,0,0,0,0,0,0,0,0,0,0,0,0,0,1,0,0,0,0,0,0,0,0,0,0,0,0,0,0,0,0,0,0,0,0,0,0
0,0,0,0,0,0,0,0,0,0,0,0,0,0,1,0,0,0,0,0,0,0,0,0,0,0,0,0,0,0,0,0,0,0,0,1,1,0,0,0,0,0,0,0,0,0,0,0,0,0,0,0,0,0,0,0,0,0,0,0
0,0,0,0,0,0,0,0,0,0,0,0,0,0,0,1,1,1,1,1,0,0,0,0,0,0,0,0,0,0,0,0,0,1,1,0,0,0,0,0,0,0,0,0,0,0,0,0,0,0,0,0,0,0,0,0,0,0,0,0
0,0,0,0,0,0,0,0,0,0,0,0,0,0,0,0,0,0,0,0,1,1,1,1,1,1,1,1,1,1,1,1,1,0,0,0,0,0,0,0,0,0,0,0,0,0,0,0,0,0,0,0,0,0,0,0,0,0,0,0

