
10,10,10,10,10,25,35,35,35,35,36,09,07,00,00,00,00,00,00,00,00,00,00,00,00,00,00,00,00,00,00,00,00,00,00,00,00,00,03,09,09,37,35,35,35,35,35,29,10,10,10,10,10,10,10,10,10,10,10,10;
10,10,10,10,10,25,35,35,35,35,36,09,07,00,00,00,00,00,00,00,00,00,00,00,00,00,00,00,00,00,00,00,00,00,00,00,00,00,03,09,09,37,35,35,35,35,35,29,10,10,10,10,10,10,10,10,10,10,10,10;
10,10,10,10,10,25,35,35,35,35,36,09,07,00,00,00,00,00,00,00,00,00,00,00,00,00,00,00,00,00,00,00,00,00,00,00,00,05,09,09,09,37,35,35,35,35,35,29,10,10,10,10,10,10,10,10,10,10,10,10;
10,10,10,10,32,26,35,35,35,35,36,09,06,05,05,05,00,00,00,00,00,00,00,00,00,00,00,00,00,00,00,00,00,00,00,00,05,09,09,09,42,46,35,35,35,35,30,34,10,10,10,10,10,10,10,10,10,10,10,10;
10,10,10,10,25,35,35,35,35,35,36,09,09,09,09,09,07,00,00,00,00,00,00,00,00,00,00,00,00,00,00,00,00,00,00,05,09,09,09,09,37,35,35,35,35,35,29,10,10,10,10,10,10,10,10,10,10,10,10,10;
10,10,10,10,25,35,35,35,35,35,36,09,09,09,09,09,06,05,05,05,05,05,05,00,00,00,00,00,00,00,00,00,00,00,00,09,09,09,09,42,46,35,35,35,35,30,34,10,10,10,10,10,10,10,10,10,10,10,10,10;
10,10,10,10,25,35,35,35,35,35,47,43,09,09,09,09,11,09,09,09,11,09,09,00,00,00,00,00,00,00,00,00,00,00,05,09,09,09,09,37,35,35,35,35,35,29,10,10,10,10,10,32,27,27,33,10,10,10,10,10;
10,10,10,10,25,35,35,35,35,35,35,36,09,09,09,18,10,12,09,18,10,12,09,05,00,00,00,00,00,00,00,00,00,00,09,09,09,09,42,46,35,35,35,35,35,29,10,10,32,27,27,26,35,35,28,33,10,10,10,10;
10,10,10,10,31,24,35,35,35,35,35,36,09,09,18,22,10,19,11,22,10,19,12,09,07,00,00,00,00,00,00,00,00,00,09,09,09,09,37,35,35,35,35,35,35,56,49,60,53,35,35,35,35,35,35,28,33,10,10,10;
10,10,10,10,10,25,35,35,35,35,35,47,43,09,16,21,10,10,10,10,10,20,14,09,07,00,00,00,00,00,00,00,00,05,09,09,09,42,46,35,35,35,35,35,57,61,49,52,35,35,35,35,35,35,35,35,29,10,10,10;
10,10,10,10,10,25,35,35,35,35,35,35,36,09,09,16,21,10,10,10,20,14,09,09,07,00,00,00,00,00,00,05,05,09,09,09,09,37,35,35,35,35,35,35,56,49,60,53,35,35,35,35,35,35,35,35,29,10,10,10;
10,10,10,10,10,25,35,35,35,35,35,35,36,09,09,09,16,21,10,10,13,09,09,07,00,00,00,00,00,00,03,09,09,09,09,42,38,46,35,35,35,35,35,57,61,49,52,35,35,35,35,35,35,35,35,35,29,10,10,10;
10,10,10,10,10,25,35,35,35,35,35,35,47,43,09,09,09,16,21,20,14,09,09,07,00,00,00,00,00,00,03,09,09,09,09,37,35,35,35,35,35,35,35,56,49,60,53,35,35,35,35,35,35,35,35,35,29,10,10,10;
10,10,10,10,10,25,35,35,35,35,35,35,35,36,09,09,09,09,16,14,09,09,09,07,00,00,00,00,00,00,03,09,09,09,09,37,35,35,35,35,35,35,57,61,49,52,35,35,35,35,35,35,35,35,35,35,29,10,10,10;
10,10,10,10,10,25,35,35,35,35,35,35,35,47,43,09,09,09,09,09,09,07,00,00,00,00,00,00,00,00,03,09,09,09,42,46,35,35,35,35,35,57,61,49,49,52,35,35,35,35,35,35,35,35,35,35,29,10,10,10;
10,10,10,10,10,31,24,35,35,35,35,35,35,35,36,09,09,09,09,09,07,00,00,00,00,00,00,00,00,00,03,09,09,42,46,35,35,35,35,35,35,56,49,49,49,52,35,35,35,35,35,35,35,35,35,30,34,10,10,10;
10,10,10,10,10,10,31,24,35,35,35,35,35,35,47,43,09,09,09,09,07,00,00,00,00,00,00,00,00,00,03,09,42,46,35,35,35,35,35,35,57,61,49,49,49,52,35,35,35,35,35,35,35,35,35,29,10,10,10,10;
10,10,10,10,10,10,10,31,24,35,35,35,35,35,35,47,43,09,09,09,07,00,00,00,00,00,00,00,00,00,03,42,46,35,35,35,35,35,35,35,29,10,49,49,49,52,35,35,35,35,35,35,35,35,35,29,10,10,10,10;
10,10,10,10,10,10,10,10,25,35,35,35,35,35,35,35,47,43,09,09,09,09,07,00,00,00,00,00,00,00,03,37,35,35,35,35,35,35,35,35,29,10,10,10,49,52,35,35,35,35,35,35,35,35,35,29,10,10,10,10;
10,10,10,10,10,10,10,10,31,24,35,35,35,35,35,35,35,47,43,09,09,09,07,00,00,00,00,00,03,09,09,37,35,35,35,35,35,35,35,30,34,10,10,10,10,25,35,35,35,35,35,35,35,35,30,34,10,10,10,10;
10,10,10,10,10,10,10,10,10,25,35,35,35,35,35,35,35,35,47,43,09,09,09,09,07,00,00,00,03,09,42,46,35,35,35,35,35,35,30,34,10,10,10,10,10,25,35,35,35,35,35,35,35,30,34,10,10,10,10,10;
10,10,10,10,10,10,10,10,10,31,23,24,35,35,35,35,35,35,35,47,43,09,09,09,09,09,09,09,09,09,37,35,35,35,35,35,35,30,34,10,10,10,10,10,10,31,24,35,35,35,35,35,30,34,10,10,10,10,10,10;
10,10,10,10,10,10,10,10,10,10,10,25,35,35,35,35,35,35,35,35,47,43,09,09,09,09,09,09,09,42,46,35,35,35,35,35,30,34,10,10,10,10,10,10,10,10,31,23,23,23,23,23,34,10,10,10,10,10,10,10;
10,10,10,10,10,10,10,10,10,10,10,31,24,35,35,35,35,35,35,35,35,47,38,43,09,09,09,09,42,46,35,35,35,35,35,35,29,10,10,10,10,10,10,10,10,10,10,10,10,10,10,10,10,10,10,10,10,10,10,10;
10,10,10,10,10,10,10,10,10,10,10,10,31,24,35,35,35,35,35,35,35,35,35,47,43,42,38,38,46,35,35,35,35,35,35,30,34,10,10,10,10,10,10,10,10,10,10,10,10,10,10,10,10,10,10,10,10,10,10,10;
10,10,10,10,10,10,10,10,10,10,10,10,10,31,24,35,35,35,35,35,35,35,35,35,47,46,35,35,35,35,35,35,35,35,35,29,10,10,10,10,10,10,10,10,10,10,10,10,10,10,10,10,10,10,10,10,10,10,10,10;
10,10,10,10,10,10,10,10,10,10,10,10,10,10,31,24,35,35,35,35,35,35,35,35,35,35,35,35,35,35,35,35,35,35,30,34,10,10,10,10,10,10,10,10,10,10,10,10,10,10,10,10,10,10,10,10,10,10,10,10;
10,10,10,10,10,10,10,10,10,10,10,10,10,10,10,31,23,23,24,35,35,35,35,35,35,35,35,35,35,35,35,35,35,30,34,10,10,10,10,10,10,10,10,10,10,10,10,10,10,10,10,10,10,10,10,10,10,10,10,10;
10,10,10,10,10,10,10,10,10,10,10,10,10,10,10,10,10,10,31,24,35,35,35,35,35,35,35,35,35,35,35,35,35,29,10,10,10,10,10,10,10,10,10,10,10,10,10,10,10,10,10,10,10,10,10,10,10,10,10,10;
10,10,10,10,10,10,10,10,10,10,10,10,10,10,10,10,10,10,10,31,24,35,35,35,35,35,35,35,35,35,35,30,23,34,10,10,10,10,10,10,10,10,10,10,10,10,10,10,10,10,10,10,10,10,10,10,10,10,10,10;
10,10,10,10,10,10,10,10,10,10,10,10,10,10,10,10,10,10,10,10,31,23,23,23,23,23,23,23,23,23,23,34,10,10,10,10,10,10,10,10,10,10,10,10,10,10,10,10,10,10,10,10,10,10,10,10,10,10,10,10;
10,10,10,10,10,10,10,10,10,10,10,10,10,10,10,10,10,10,10,10,10,10,10,10,10,10,10,10,10,10,10,10,10,10,10,10,10,10,10,10,10,10,10,10,10,10,10,10,10,10,10,10,10,10,10,10,10,10,10,10;
10,10,10,10,10,10,10,10,10,10,10,10,10,10,10,10,10,10,10,10,10,10,10,10,10,10,10,10,10,10,10,10,10,10,10,10,10,10,10,10,10,10,10,10,10,10,10,10,10,10,10,10,10,10,10,10,10,10,10,10;
10,10,10,10,10,10,10,10,10,10,10,10,10,10,10,10,10,10,10,10,10,10,10,10,10,10,10,10,10,10,10,10,10,10,10,10,10,10,10,10,10,10,10,10,10,10,10,10,10,10,10,10,10,10,10,10,10,10,10,10;

0,0,0,0,1,0,0,0,0,0,0,0,0,0,0,0,0,0,0,0,0,0,0,0,0,0,0,0,0,0,0,0,0,0,0,0,0,0,0,0,0,0,0,0,0,0,0,0,1,0,0,0,0,0,0,0,0,0,0,0
0,0,0,0,1,0,0,0,0,0,0,0,0,0,0,0,0,0,0,0,0,0,0,0,0,0,0,0,0,0,0,0,0,0,0,0,0,0,0,0,0,0,0,0,0,0,0,0,1,0,0,0,0,0,0,0,0,0,0,0
0,0,0,0,1,0,0,0,0,0,0,0,0,0,0,0,0,0,0,0,0,0,0,0,0,0,0,0,0,0,0,0,0,0,0,0,0,0,0,0,0,0,0,0,0,0,0,0,1,0,0,0,0,0,0,0,0,0,0,0
0,0,0,0,1,0,0,0,0,0,0,0,0,0,0,0,0,0,0,0,0,0,0,0,0,0,0,0,0,0,0,0,0,0,0,0,0,0,0,0,0,0,0,0,0,0,0,1,0,0,0,0,0,0,0,0,0,0,0,0
0,0,0,1,0,0,0,0,0,0,0,0,0,0,0,0,0,0,0,0,0,0,0,0,0,0,0,0,0,0,0,0,0,0,0,0,0,0,0,0,0,0,0,0,0,0,0,1,0,0,0,0,0,0,0,0,0,0,0,0
0,0,0,1,0,0,0,0,0,0,0,0,0,0,0,0,0,0,0,0,0,0,0,0,0,0,0,0,0,0,0,0,0,0,0,0,0,0,0,0,0,0,0,0,0,0,1,0,0,0,0,0,1,1,0,0,0,0,0,0
0,0,0,1,0,0,0,0,0,0,0,0,0,0,0,0,0,0,0,0,0,0,0,0,0,0,0,0,0,0,0,0,0,0,0,0,0,0,0,0,0,0,0,0,0,0,1,0,1,1,1,1,0,0,1,0,0,0,0,0
0,0,0,1,0,0,0,0,0,0,0,0,0,0,0,0,0,0,0,0,0,0,0,0,0,0,0,0,0,0,0,0,0,0,0,0,0,0,0,0,0,0,0,0,0,0,1,1,1,0,0,0,0,0,0,1,0,0,0,0
0,0,0,0,1,0,0,0,0,0,0,0,0,0,0,0,0,0,0,0,0,0,0,0,0,0,0,0,0,0,0,0,0,0,0,0,0,0,0,0,0,0,0,0,0,0,0,0,0,0,0,0,0,0,0,0,1,0,0,0
0,0,0,0,1,0,0,0,0,0,0,0,0,0,0,0,0,0,0,0,0,0,0,0,0,0,0,0,0,0,0,0,0,0,0,0,0,0,0,0,0,0,0,0,0,0,0,0,0,0,0,0,0,0,0,0,0,1,0,0
0,0,0,0,1,0,0,0,0,0,0,0,0,0,0,0,0,0,0,0,0,0,0,0,0,0,0,0,0,0,0,0,0,0,0,0,0,0,0,0,0,0,0,0,0,0,0,0,0,0,0,0,0,0,0,0,0,1,0,0
0,0,0,0,1,0,0,0,0,0,0,0,0,0,0,0,0,0,0,0,0,0,0,0,0,0,0,0,0,0,0,0,0,0,0,0,0,0,0,0,0,0,0,0,0,0,0,0,0,0,0,0,0,0,0,0,0,1,0,0
0,0,0,0,1,0,0,0,0,0,0,0,0,0,0,0,0,0,0,0,0,0,0,0,0,0,0,0,0,0,0,0,0,0,0,0,0,0,0,0,0,0,0,0,0,0,0,0,0,0,0,0,0,0,0,0,0,1,0,0
0,0,0,0,1,0,0,0,0,0,0,0,0,0,0,0,0,0,0,0,0,0,0,0,0,0,0,0,0,0,0,0,0,0,0,0,0,0,0,0,0,0,0,0,0,0,0,0,0,0,0,0,0,0,0,0,0,1,0,0
0,0,0,0,1,0,0,0,0,0,0,0,0,0,0,0,0,0,0,0,0,0,0,0,0,0,0,0,0,0,0,0,0,0,0,0,0,0,0,0,0,0,0,0,0,0,0,0,0,0,0,0,0,0,0,0,0,1,0,0
0,0,0,0,0,1,0,0,0,0,0,0,0,0,0,0,0,0,0,0,0,0,0,0,0,0,0,0,0,0,0,0,0,0,0,0,0,0,0,0,0,0,0,0,0,0,0,0,0,0,0,0,0,0,0,0,1,0,0,0
0,0,0,0,0,0,1,0,0,0,0,0,0,0,0,0,0,0,0,0,0,0,0,0,0,0,0,0,0,0,0,0,0,0,0,0,0,0,0,0,0,0,0,0,0,0,0,0,0,0,0,0,0,0,0,0,1,0,0,0
0,0,0,0,0,0,0,1,0,0,0,0,0,0,0,0,0,0,0,0,0,0,0,0,0,0,0,0,0,0,0,0,0,0,0,0,0,0,0,0,0,1,0,0,0,0,0,0,0,0,0,0,0,0,0,0,1,0,0,0
0,0,0,0,0,0,0,1,0,0,0,0,0,0,0,0,0,0,0,0,0,0,0,0,0,0,0,0,0,0,0,0,0,0,0,0,0,0,0,0,0,1,1,1,0,0,0,0,0,0,0,0,0,0,0,0,1,0,0,0
0,0,0,0,0,0,0,0,1,0,0,0,0,0,0,0,0,0,0,0,0,0,0,0,0,0,0,0,0,0,0,0,0,0,0,0,0,0,0,0,1,0,0,0,1,0,0,0,0,0,0,0,0,0,0,1,0,0,0,0
0,0,0,0,0,0,0,0,1,0,0,0,0,0,0,0,0,0,0,0,0,0,0,0,0,0,0,0,0,0,0,0,0,0,0,0,0,0,0,1,0,0,0,0,1,0,0,0,0,0,0,0,0,0,1,0,0,0,0,0
0,0,0,0,0,0,0,0,0,1,0,0,0,0,0,0,0,0,0,0,0,0,0,0,0,0,0,0,0,0,0,0,0,0,0,0,0,0,1,0,0,0,0,0,0,1,0,0,0,0,0,0,0,1,0,0,0,0,0,0
0,0,0,0,0,0,0,0,0,0,1,0,0,0,0,0,0,0,0,0,0,0,0,0,0,0,0,0,0,0,0,0,0,0,0,0,0,1,0,0,0,0,0,0,0,0,1,0,0,0,0,0,1,0,0,0,0,0,0,0
0,0,0,0,0,0,0,0,0,0,0,1,0,0,0,0,0,0,0,0,0,0,0,0,0,0,0,0,0,0,0,0,0,0,0,0,0,1,0,0,0,0,0,0,0,0,0,1,1,1,1,1,0,0,0,0,0,0,0,0
0,0,0,0,0,0,0,0,0,0,0,0,1,0,0,0,0,0,0,0,0,0,0,0,0,0,0,0,0,0,0,0,0,0,0,0,1,0,0,0,0,0,0,0,0,0,0,0,0,0,0,0,0,0,0,0,0,0,0,0
0,0,0,0,0,0,0,0,0,0,0,0,0,1,0,0,0,0,0,0,0,0,0,0,0,0,0,0,0,0,0,0,0,0,0,0,1,0,0,0,0,0,0,0,0,0,0,0,0,0,0,0,0,0,0,0,0,0,0,0
0,0,0,0,0,0,0,0,0,0,0,0,0,0,1,0,0,0,0,0,0,0,0,0,0,0,0,0,0,0,0,0,0,0,0,1,0,0,0,0,0,0,0,0,0,0,0,0,0,0,0,0,0,0,0,0,0,0,0,0
0,0,0,0,0,0,0,0,0,0,0,0,0,0,0,1,0,0,0,0,0,0,0,0,0,0,0,0,0,0,0,0,0,0,1,0,0,0,0,0,0,0,0,0,0,0,0,0,0,0,0,0,0,0,0,0,0,0,0,0
0,0,0,0,0,0,0,0,0,0,0,0,0,0,0,0,1,1,1,0,0,0,0,0,0,0,0,0,0,0,0,0,0,0,1,0,0,0,0,0,0,0,0,0,0,0,0,0,0,0,0,0,0,0,0,0,0,0,0,0
0,0,0,0,0,0,0,0,0,0,0,0,0,0,0,0,0,0,0,1,0,0,0,0,0,0,0,0,0,0,0,0,0,1,0,0,0,0,0,0,0,0,0,0,0,0,0,0,0,0,0,0,0,0,0,0,0,0,0,0
0,0,0,0,0,0,0,0,0,0,0,0,0,0,0,0,0,0,0,0,1,0,0,0,0,0,0,0,0,0,0,1,1,0,0,0,0,0,0,0,0,0,0,0,0,0,0,0,0,0,0,0,0,0,0,0,0,0,0,0
0,0,0,0,0,0,0,0,0,0,0,0,0,0,0,0,0,0,0,0,0,1,1,1,1,1,1,1,1,1,1,0,0,0,0,0,0,0,0,0,0,0,0,0,0,0,0,0,0,0,0,0,0,0,0,0,0,0,0,0
0,0,0,0,0,0,0,0,0,0,0,0,0,0,0,0,0,0,0,0,0,0,0,0,0,0,0,0,0,0,0,0,0,0,0,0,0,0,0,0,0,0,0,0,0,0,0,0,0,0,0,0,0,0,0,0,0,0,0,0
0,0,0,0,0,0,0,0,0,0,0,0,0,0,0,0,0,0,0,0,0,0,0,0,0,0,0,0,0,0,0,0,0,0,0,0,0,0,0,0,0,0,0,0,0,0,0,0,0,0,0,0,0,0,0,0,0,0,0,0

