10,25,35,36,09,07,00,00,00,00,00,03,09,09,09,09,09,09,09,09,09,17,10,10,10;
10,25,35,35,36,07,00,00,00,00,00,00,03,09,09,09,01,00,02,09,09,17,10,10,10;
10,31,24,35,36,06,05,00,00,00,00,00,03,09,01,01,00,00,00,03,09,17,10,10,10;
10,10,25,35,36,09,09,00,00,00,05,05,09,01,00,00,00,00,00,03,09,17,10,10,10;
10,10,25,35,35,36,09,05,05,05,09,09,01,00,00,00,00,00,00,03,09,17,10,10,10;
10,10,31,24,35,36,09,09,09,09,09,01,00,00,00,00,00,00,04,09,09,17,10,10,10;
10,10,10,25,35,36,09,09,08,01,01,00,00,00,00,05,05,05,09,09,09,17,10,10,10;
10,10,10,25,35,36,09,09,07,00,00,00,00,00,03,42,38,38,38,09,09,17,10,10,10;
10,10,10,25,35,35,36,09,07,00,00,00,00,00,03,37,35,35,30,11,11,22,10,10,10;
10,10,10,31,24,35,36,09,07,00,00,00,00,00,03,37,35,30,34,10,10,10,10,10,10;
10,10,10,10,25,35,36,09,09,06,00,00,00,04,09,37,35,29,10,10,10,32,27,27,33;
10,10,10,10,25,35,35,36,09,09,05,05,05,09,09,37,35,29,10,10,32,26,35,35,29;
10,10,10,10,31,24,35,36,09,09,09,09,09,09,09,37,35,29,10,10,25,35,35,35,29;
10,10,10,10,10,25,35,35,36,09,09,09,09,09,37,35,35,29,10,10,25,35,35,30,34;
10,10,10,10,10,31,24,35,36,09,09,09,37,35,35,35,30,34,10,10,31,23,23,34,10;
10,10,10,10,10,10,25,35,35,38,38,38,35,35,30,23,34,10,10,10,10,10,10,10,10;
10,10,10,10,10,10,25,35,35,35,35,35,35,30,34,10,10,10,10,10,10,10,10,10,10;
10,10,10,10,10,10,31,24,35,35,30,23,23,34,10,10,10,10,10,10,10,10,10,10,10;
10,10,10,10,10,10,10,31,23,23,34,10,10,10,10,10,10,10,10,10,10,10,10,10,10;
10,10,10,10,10,10,10,10,10,10,10,10,10,10,10,10,10,10,10,10,10,10,10,10,10;

1,0,0,0,0,0,0,0,0,0,0,0,0,0,0,0,0,0,0,0,0,0,1,0,0
1,0,0,0,0,0,0,0,0,0,0,0,0,0,0,0,0,0,0,0,0,0,1,0,0
1,0,0,0,0,0,0,0,0,0,0,0,0,0,0,0,0,0,0,0,0,0,1,0,0
0,1,0,0,0,0,0,0,0,0,0,0,0,0,0,0,0,0,0,0,0,0,1,0,0
0,1,0,0,0,0,0,0,0,0,0,0,0,0,0,0,0,0,0,0,0,0,1,0,0
0,1,0,0,0,0,0,0,0,0,0,0,0,0,0,0,0,0,0,0,0,0,1,0,0
0,0,1,0,0,0,0,0,0,0,0,0,0,0,0,0,0,0,0,0,0,0,1,0,0
0,0,1,0,0,0,0,0,0,0,0,0,0,0,0,0,0,0,0,0,0,0,1,0,0
0,0,1,0,0,0,0,0,0,0,0,0,0,0,0,0,0,0,0,0,0,0,1,0,0
0,0,1,0,0,0,0,0,0,0,0,0,0,0,0,0,0,0,0,1,1,1,1,0,0
0,0,0,1,0,0,0,0,0,0,0,0,0,0,0,0,0,0,1,0,0,0,0,0,0
0,0,0,1,0,0,0,0,0,0,0,0,0,0,0,0,0,0,1,0,0,0,0,0,0
0,0,0,1,0,0,0,0,0,0,0,0,0,0,0,0,0,0,1,0,0,0,0,0,0
0,0,0,0,1,0,0,0,0,0,0,0,0,0,0,0,0,0,1,0,0,0,0,0,0
0,0,0,0,1,0,0,0,0,0,0,0,0,0,0,0,0,0,1,0,0,0,0,0,0
0,0,0,0,0,1,0,0,0,0,0,0,0,0,0,0,0,1,1,0,0,0,0,0,0
0,0,0,0,0,1,0,0,0,0,0,0,0,0,0,1,1,0,0,0,0,0,0,0,0
0,0,0,0,0,1,0,0,0,0,0,0,0,0,1,0,0,0,0,0,0,0,0,0,0
0,0,0,0,0,0,1,0,0,0,0,1,1,1,0,0,0,0,0,0,0,0,0,0,0
0,0,0,0,0,0,0,1,1,1,1,0,0,0,0,0,0,0,0,0,0,0,0,0,0
